         __________                                      
        /\____;;___\                                     
       | /         /  
       `. ())oo() .                                      
        |\(%()*^^()^\    
       %| |-%-------|                                    
      % \ | %  ))   |                                    
      %  \|%________|                                    
  %%%%        
